11.........12.........13.........14.........15.........16.........17.........18.........19.........20.........
10.........12.........13.........14.........15.........16.........17.........18.........19.........20.........
10.........11.........13.........14.........15.........16.........17.........18.........19.........20.........
10.........11.........12.........14.........15.........16.........17.........18.........19.........20.........
10.........11.........12.........13.........15.........16.........17.........18.........19.........20.........
10.........11.........12.........13.........14.........16.........17.........18.........19.........20.........
10.........11.........12.........13.........14.........15.........17.........18.........19.........20.........
10.........11.........12.........13.........14.........15.........16.........18.........19.........20.........
10.........11.........12.........13.........14.........15.........16.........17.........19.........20.........
10.........11.........12.........13.........14.........15.........16.........17.........18.........20.........
